11111111111111111111
10000000000000000001
10000000C00000000001
10000000000000000001
10000000000000000001
10000000000000000001
10000000E00001C10001
1000000P000000100001
10000000000000000001
10000000000000000001
11111111111111111111



