1111111111111
1000C00000001
1000C00000001
1000C00000001
10E00000000M1
100P000000001
1111111111111
