111111111111111111111111111111111111111111111111111111111111111111111111111111111111111111111111111111111
1PCE000000000000000000000000000000110C0000000000000000000000000000000110C00000000000000000000000000000001
1000010C0000000000000000000000000000000110C0000000000000000000000000000000110C000000000000000000000000001
100C110C000000000000000000000000000000011000000000000000000000000000000000110C000000000000000000000000001
111111111111111111111111111111111111111111111111111111111111111111111111111111111111111011111111111111111
111111111111111111111111111111111111111111111111111111111111111111111111111111111111111011111111111111111
10C0000000000000000000000000000000110C0000000000000000000000000000000110C00000000000000000000000000000001
1000010C0000000000000000000000000000000110C0000000000000000000000000000000110C000000000000000000000000001
100C110C000000000000000000000000000000011000000000000000000000000000000000110C000000000000000000000000001
111111111111111111111111111111111111111111111111111111111111111111111111111111111111111111111110111111111
100C110C000000000000000000000000000000011000000000000000000000000000000000110C000000000000000000000000001
110111111111111101111111111111111111111111111111111111111111111111111111111111101111111110111111111111111
10C0000000000000000000000000000000110C0000000000000000000000000000000110C00000000000000000000000000000001
1000010C0000000000000000000000000000000110C0000000000000000000000000000000110C000000000000000000000000001
100C110C000000000000000000000000000000011000000000000000000000000000000000110C000000000000000000000000001
111111111111110111111111111101111111111111111111111111111111111111111111111111111111111111111111111111111
10C0000000000000000000000000000000110C0000000000000000000000000000000110C00000000000000000000000000000001
1000010C0000000000000000000000000000000110C0000000000000000000000000000000110C000000000000000000000000001
100C110C000000000000000000000000000000011000000000000000000000000000000000110C000000000000000000000000001
111111111111111111111111111111111111111111111111111111111111111111111111111111111111111111110111111111111
10C0000000000000000000000000000000110C0000000000000000000000000000000110C00000000000000000000000000000001
1000010C0000000000000000000000000000000110C0000000000000000000000000000000110C000000000000000000000000001
100C110C000000000000000000000000000000011000000000000000000000000000000000110C000000000000000000000000001
111111111111111111111111111111111111111111111111111111111111111111111111111111111111111111111111111111111
